0000000000000000000000000000000000000000000000000000000000000000000000000000000
0                                                                             >
0                                                                             >
0                                                                             >
0                                                                             >
0                                                                             >
0                                                                             >
0                                                                             >
0                                                                             >
0                                                                             >
0                                                                             >
0                                                                             >
0                                                                             >
0                                                                             >
0                                                                             >
0                                                                             >
0                                                                             >
0                                                                             >
0                                                                             >
0   X                                                                         >
0  X X                              o                                         >
0   X                                                                         >
0                                                                             >
0                                                                             >
0                                                                             >
0                                                                             >
0                                                                             >
0                                                                             >
0                                                                             >
0                                                                             >
0                                                                             >
0                                                                             >
0                                                                             >
0                                                                             >
0                                                                             >
0                                                                             >
0                                                                             >
0                                                                             >
0                                                                             >
0000000000000000000000000000000000000000000000000000000000000000000000000000000
