XXXXXXXXXXXXXXXXXXXXXXXXXXXXXXXXXXXXXXXXXXXXXXXXXXXXXXXXXXXXXXXXXXXXXXXXXXXXXXX
<                                                                             >
<                                                                             >
<                                                                             >
<                                                                             >
<                                                                             >
<                                                                             >
<                                                                             >
<                                                                             >
<                                                                             >
<                                                                             >
<                                                                             >
<                                                                             >
<                                                                             >
<                                                                             >
<                                                                             >
<                                                                             >
<                                                                             >
<                                                                        X    >
<                                                                             >
<                                                                             >
<                                                                             >
<                                                                             >
<                                                                             >
<                                                                             >
<                                                                             >
<                                                                             >
<                                                                             >
<                                                                             >
<                                                                             >
<                                                                             >
<                                                                             >
<                                                                             >
<                                                                             >
<                                                                             <
<                                                                             >
<                                                                             >
<                                                                             >
<                                                                             >
XXXXXXXXXXXXXXXXXXXXXXXXXXXXXXXXXXXXXXXXXXXXXXXXXXXXXXXXXXXXXXXXXXXXXXXXXXXXXXX
