0000000000000000000000000000000000000000000000000000000000000000000000000000000
<X                                                                            0
<X                                                                            0
<X                                                                            0
<X                                                                            0
<X                                                                            0
<X                                                                            0
<X                                                                            0
<X                                                                            0
<X                                                                            0
<X                                                                            0
<X                                                                            0
<X                                                                            0
<X                                                                            0
<X                                                             ***************0
<X                                                            * *           * 0
<X                                                          **   *         *  0
<X                                                                 0XXXXX0    0
<X                                                                 XXXXXXX    0
<X                                                                 XXXgXXX    0
<X                                                                 XXXXXXX    0
<X                                                                 0XXXXX0    0
<X                                                          **   *         *  0
<X                                                            * *           * 0
<X                                                             ***************0
<X                                                                            0
<X                                                                            0
<X                                                                            0
<X                                                                            0
<X                                                                            0
<X                                                                            0
<X                                                                            0
<X                                                                            0
<X                                                                            0
<X                                                                            0
<X                                                                            0
<X                                                                            0
<X                                                                            0
0000000000000000000000000000000000000000000000000000000000000000000000000000000
